aderholt	R
allred	D
babin	R
bacon	R
balart	R
balderson	R
beatty	D
bera	D
beyer	D
bishop	R
blunt	R
boyle	D
brindisi	D
brooks	R
brown	D
brownley	D
buchanan	R
budd	R
burchett	R
bustos	D
butterfield	D
calvert	R
carson	D
cicilline	D
cisneros	D
clarke	D
cline	R
coleman	D
collins	R
con	U
conaway	R
connolly	D
cook	R
cooper	D
crawford	R
dean	D
defazio	D
degette	D
desaulnier	D
dingell	D
doyle	D
engel	D
escobar	D
eshoo	D
espaillat	D
fitzpatrick	R
fudge	D
gaetz	R
garcia	D
gibbs	R
gottheimer	D
griffith	R
haaland	D
hagedorn	R
harris	R
hartzler	R
hastings	D
hayes	D
hern	R
holding	R
horsford	D
houlahan	D
hoyer	D
huffman	D
johnson	R
joyce	R
kaptur	D
katko	R
keating	D
kennedy	R
khanna	D
kim	D
kind	D
king	I
kinzinger	R
kuster	D
kustoff	R
lamalfa	R
larsen	D
lawson	D
lee	D
lewis	D
lieu	D
lipinski	D
lofgren	D
luria	D
malinowski	D
maloney	D
marshall	R
matsui	D
mccaul	R
mcclintock	R
mcgovern	D
meeks	D
meng	D
mullin	R
murphy	D
nadler	D
neguse	D
norton	D
nunes	R
omar	D
palazzo	R
palmer	R
panetta	D
pascrell	D
patrick	U
payne	D
perry	R
pocan	D
posey	R
pressley	D
price	D
raskin	D
res	U
rice	D
riggleman	R
rochester	D
rose	R
rouzer	R
roy	R
rush	D
scanlon	D
schakowsky	D
schiff	D
schultz	D
scott	R
sherman	D
sherrill	D
soto	D
spanberger	D
spano	R
speier	D
stefanik	R
stewart	R
stivers	R
suozzi	D
swalwell	D
takano	D
thompson	D
tipton	R
turner	R
underwood	D
vargas	D
velazquez	D
visclosky	D
wagner	R
waters	D
welch	D
wenstrup	R
wexton	D
wild	D
wilson	D
wittman	R
zeldin	R